############
#....##....#
#.##.##.##.#
#..........#
#.##.##.##.#
#....##...x#
############